############
#@@@|@@#@###
#@@@@@@#@DX#
#@@@@@@@-###
#P@@@@@#@X##
#@@@@@@#@###
#@XXXXX#@D##
#@@@@GD#####
############