#######
#@P@@@#
###@|@#
###D@@#
###@@X#
#XD@@X#
#######