###########
#@@@@G@@@@#
#D@@@@@@#D#
#@@@#@#@@@#
##-@@P@@-##
#@@@#@#@@@#
#D@@@@@@#D#
#@@@@G@@@@#
###########