#########
#P@@G@XX#
#@|@@@@@#
#@@@@##D#
#@@X@##@#
#@@X@DXD#
#########