#########
##@@@@@##
#@@@D@@@#
#-GDPDG-#
#@@@D@@@#
##@@@@@##
#########