########
#@@@@@@#
#@@@@@D#
#P@-@@D#
#@@@@@@#
########