###########
#P@@@@@@@G#
#@|@@@#@#@#
#@@@@@@@@@#
#@@@@@@D#D#
#@@@@@@####
#@@@@@@@D@#
###########