##########
##@@@@@@##
##@@@@@@##
##@X#@@DX#
#P@G@@@@D#
#@|@@@@DX#
#@@@@@@@@#
##########