#########
#@@@@@@D#
#P@-@@@D#
#@@@G-@D#
#@@@@@@@#
#########