###########
#@@@@G@@@@#
#@@D@|@D@@#
#@@@@@@@@@#
#G@-@P@-@G#
#@@@@@@@@@#
#@@D@|@D@@#
#@@@@G@@@@#
###########