###########
#D#@@P@@@@#
#@@@@@@@@@#
#@@@@@@@G@#
##@@-@@@XX#
#@@@@@@@@D#
#@@@@@@@#X#
#@@@@@@@@D#
###########