#######
#@@@@@#
#@P@@D#
#@@@@@#
#######