##########
##@@@@@@##
##@@@@@@##
##PX#@@BX#
#X@G@@@@D#
#@|@@@@BX#
#@@@@@@###
##########